0000000000000000000000000000000000000000000000000000000000000000000000000000000000000000000000000000000000000000000000000000000000000000000000000000000000000000000000000000000000000000000000
0000000000000000000000000000000000000000000000000000000000000000000000000000000000000000000000000000000000000000000000000000000000000000000000000000000000000000000000000000000000000000000000
0000000000000000000000000000000000000000000000e111111h0000000000000000000000000000000000000000000000000000000000000000000000000000000000000000000000000000000000000000000000000000000000000000
000000000000000000000000000000000000000000000e1lL00aA1h000000000000000000000000000000000000000000000000000000000000000000000000000000000000000000000000000000000000000000000000000000000000000
00000000000000000000000000000000000000000000e1k000000b1h00000000000000000000000000000000000000000000000000000000000000000000000000000000000000000000000000000000000000000000000000000000000000
0000000000000000000000000000000000000000000e1J00000000c1h0000000000000000000000000000000000000000000000000000000000000000000000000000000000000000000000000000000000000000000000000000000000000
000000000000000000000000000000000000000000e11j00000000C11h000000000000000000000000000000000000000000000000000000000000000000000000000000000000000000000000000000000000000000000000000000000000
000000000e1h000e1h000e1h000e1h000e1h0000Ff11k0000000000b11Gg0000e1h000e1h000e1h000e1h000e1h000000000000000000000000000000000000000000000000000000000000000000000000000000000000000000000000000
111111111111111111111111111111111111111111lL000000000000aA111111111111111111111111111111111111111100000000000000000000000000000000000000000000000000000000000000000000000000000000000000000000
11111111111111lL0x0000000x000000x000000x00000000030000000000x000000x000000x0000000x0aA11111111111100000000000000000000000000000000000000000000000000000000000000000000000000000000000000000000
1111111111111k000x0000000x000000x000000x00000000111100000000x000000x000000x0000000x000b1111111111100000000000000000000000000000000000000000000000000000000000000000000000000000000000000000000
111111111111k0000x0000000x000000x000000x00000000000000000000x000000x000000x0000000x0000b111111111100000000000000000000000000000000000000000000000000000000000000000000000000000000000000000000
11111111111J00000x0000000x000000x000000x00000000000000000000x000000x000000x0000000x00000c11111111100000000000000000000000000000000000000000000000000000000000000000000000000000000000000000000
11111111111j00000x0000000x000000x000000x00001100000000110000x000000x000000x0000000x00000C11111111100000000000000000000000000000000000000000000000000000000000000000000000000000000000000000000
11111111111000000x0000000x000000x000000x00000000000000000000x000000x000000x0000000x00000011111111100000000000000000000000000000000000000000000000000000000000000000000000000000000000000000000
11111111111000000x0000020x020020x020020x02002000200200020020x020020x020020x0200000x00000011111111100000000000000000000000000000000000000000000000000000000000000000000000000000000000000000000
11111111111000000x0000011111001111100111110011111001111100111110011111001111100000x00000011111111100000000000000000000000000000000000000000000000000000000000000000000000000000000000000000000
11111111111000011111000aA1lL00aA1lL00aA1lL00aA1lL00aA1lL00aA1lL00aA1lL00aA1lL00011111000011111111100000000000000000000000000000000000000000000000000000000000000000000000000000000000000000000
11111111111000000x0000000100000010000001000000100000010000001000000100000010000000x00000011111111100000000000000000000000000000000000000000000000000000000000000000000000000000000000000000000
11111111111000000x0000000100000010000001000000J00000010000001000000c00000010000000x00000011111111100000000000000000000000000000000000000000000000000000000000000000000000000000000000000000000
11111111111110000x0000000c0000001000000c000000j00000010000001000000C000000J0000000x00001111111111100000000000000000000000000000000000000000000000000000000000000000000000000000000000000000000
11111111111000000x0000000C000000J000000C0000000000000c000000J0000000000000j0000000x00000011111111100000000000000000000000000000000000000000000000000000000000000000000000000000000000000000000
11111111111000000x00000000000000j00000000000000000000C000000j000000000000000000000x00000011111111100000000000000000000000000000000000000000000000000000000000000000000000000000000000000000000
1111111111100001111100000000000000000000000000000000000000000000000000000000000011111000011111111100000000000000000000000000000000000000000000000000000000000000000000000000000000000000000000
1111111111100000000000000000000000000000000000000000000000000000000000000000000000000000011111111100000000000000000000000000000000000000000000000000000000000000000000000000000000000000000000
1111111111100000000000000000000000000000000000000000000000000000000000000000000000000000011111111100000000000000000000000000000000000000000000000000000000000000000000000000000000000000000000
1111111111111g000000000200020020002002000200200020020002002000200200020020002000000000F1111111111100000000000000000000000000000000000000000000000000000000000000000000000000000000000000000000
111111111111111g00000011111100111110011111001111100111110011111001111100111111000000F111111111111100000000000000000000000000000000000000000000000000000000000000000000000000000000000000000000
11111111111111111g00000aA1lL00aA1lL00aA1lL00aA1lL00aA1lL00aA1lL00aA1lL00aA1lL00000F11111111111111100000000000000000000000000000000000000000000000000000000000000000000000000000000000000000000
1111111111111111111g00000J000000100000010000001000000100000010000001000000c00000F1111111111111111100000000000000000000000000000000000000000000000000000000000000000000000000000000000000000000
111111111111111111111g000j000000c00000010000001000000100000010000001000000C000F111111111111111111100000000000000000000000000000000000000000000000000000000000000000000000000000000000000000000
11111111111111111111111g00000000C0000001000000100000010000001000000J00000000F11111111111111111111100000000000000000000000000000000000000000000000000000000000000000000000000000000000000000000
1111111111111111111111111g0000000000000J00000010000001000000c000000j000000F1111111111111111111111100000000000000000000000000000000000000000000000000000000000000000000000000000000000000000000
111111111111111111111111111g00000000000j0000001000000J000000C00000000000F111111111111111111111111100000000000000000000000000000000000000000000000000000000000000000000000000000000000000000000
11111111111111111111111111111g00000000000000001000000j0000000000000000F11111111111111111111111111100000000000000000000000000000000000000000000000000000000000000000000000000000000000000000000
1111111111111111111111111111111g00000000000000c000000000000000000000F1111111111111111111111111111100000000000000000000000000000000000000000000000000000000000000000000000000000000000000000000
111111111111111111111111111111111g000000000000C0000000000000000000F111111111111111111111111111111100000000000000000000000000000000000000000000000000000000000000000000000000000000000000000000
11111111111111111111111111111111111g0000000000000000000000000000F11111111111111111111111111111111100000000000000000000000000000000000000000000000000000000000000000000000000000000000000000000
1111111111111111111111111111111111111g000000000000000000000000F1111111111111111111111111111111111100000000000000000000000000000000000000000000000000000000000000000000000000000000000000000000
111111111111111111111111111111111111111g00000000000000000000F111111111111111111111111111111111111100000000000000000000000000000000000000000000000000000000000000000000000000000000000000000000
11111111111111111111111111111111111111111g0000000000000000F11111111111111111111111111111111111111100000000000000000000000000000000000000000000000000000000000000000000000000000000000000000000
1111111111111111111111111111111111111111111111111111111111111111111111111111111111111111111111111100000000000000000000000000000000000000000000000000000000000000000000000000000000000000000000
1111111111111111111111111111111111111111111111111111111111111111111111111111111111111111111111111100000000000000000000000000000000000000000000000000000000000000000000000000000000000000000000
1111111111111111111111111111111111111111111111111111111111111111111111111111111111111111111111111100000000000000000000000000000000000000000000000000000000000000000000000000000000000000000000
1111111111111111111111111111111111111111111111111111111111111111111111111111111111111111111111111100000000000000000000000000000000000000000000000000000000000000000000000000000000000000000000
1111111111111111111111111111111111111111111111111111111111111111111111111111111111111111111111111100000000000000000000000000000000000000000000000000000000000000000000000000000000000000000000