1111111111111111111111111111111111111111111111111111111111111111111111111111111111111111111111111100000000000000000000000000000000000000000000000000000000000000000000000000000000000000000000
1111111111111111111111111111111111111111111111111111111111111111111111111111111111111111111111111100000000000000000000000000000000000000000000000000000000000000000000000000000000000000000000
1111111111111111111111111111111111111111111111111111111111111111111111111111111111111111111111111100000000000000000000000000000000000000000000000000000000000000000000000000000000000000000000
1111111111111111111111111111111111111111111111111111111111111111111111111111111111111111111111111100000000000000000000000000000000000000000000000000000000000000000000000000000000000000000000
1111111111111111111111111111111111111111111111111111111111111111111111111111111111111111111111111100000000000000000000000000000000000000000000000000000000000000000000000000000000000000000000
1111111111111111111111111111111111111111111111111111111111111111111111111111111111111111111111111100000000000000000000000000000000000000000000000000000000000000000000000000000000000000000000
1111111111111111111111111111111111111111111111111111111111111111111111111111111111111111111111111100000000000000000000000000000000000000000000000000000000000000000000000000000000000000000000
1111111111111111111111111111111111111111111111111111111111111111111111111111111111111111111111111100000000000000000000000000000000000000000000000000000000000000000000000000000000000000000000
111111111110000000000000x000000000000000000000000000000000000000x000000x0000001111111111111111111100000000000000000000000000000000000000000000000000000000000000000000000000000000000000000000
111111111110000000000000x000000000000000000000000000000000000000x000000x0000001111111111111111111100000000000000000000000000000000000000000000000000000000000000000000000000000000000000000000
111111111110000000000000x000000000000000000000000000000000000000x000000x0000001111111111111111111100000000000000000000000000000000000000000000000000000000000000000000000000000000000000000000
111111111110000000000000x000000000000000000000000000000000000000x000000x0000001111111111111111111100000000000000000000000000000000000000000000000000000000000000000000000000000000000000000000
111111111110000000000000x004000000000000000000000000000000000000x000000x0000001111111111111111111100000000000000000000000000000000000000000000000000000000000000000000000000000000000000000000
11111111111000000000000011111111111111111111111111111111111111111000000x0000001111111111111111111100000000000000000000000000000000000000000000000000000000000000000000000000000000000000000000
111111111110000000000000x00000000x0000000x000000x0000000x00000000000000x0000001111111111111111111100000000000000000000000000000000000000000000000000000000000000000000000000000000000000000000
111111111110000000000000x00000000x0000000x000000x0000000x0000000000000110000001111111111111111111100000000000000000000000000000000000000000000000000000000000000000000000000000000000000000000
111111111110000000000000x00000000x0000000x000000x0000000x0000000000011lL0000001111111111111111111100000000000000000000000000000000000000000000000000000000000000000000000000000000000000000000
111111111110000000000000x00000000x00Ggg00x000000x0000000x00000000011lL000000001111111111111111111100000000000000000000000000000000000000000000000000000000000000000000000000000000000000000000
111111111110000000000000x00000000x00lLL00x000000x0000000x000000011lL00000000001111111111111111111100000000000000000000000000000000000000000000000000000000000000000000000000000000000000000000
111111111110000000000000x00000001100000001100000x00Ggg00x0000011lL0000000000001111111111111111111100000000000000000000000000000000000000000000000000000000000000000000000000000000000000000000
111111111110000000000000x0000011lL0000000aA11000x00lLL00x00011lL000000000000001111111111111111111100000000000000000000000000000000000000000000000000000000000000000000000000000000000000000000
111111111110000000000000x00011lL00000000000aA110x0000000x011lL00000000000000001111111111111111111100000000000000000000000000000000000000000000000000000000000000000000000000000000000000000000
111111111110000000000000x011lL000000000000000aA11000000011lL0000000000000000001111111111111111111100000000000000000000000000000000000000000000000000000000000000000000000000000000000000000000
11111111111000000000000011lL000000000000000000000000000000000000000000000000001111111111111111111100000000000000000000000000000000000000000000000000000000000000000000000000000000000000000000
1111111111100000000000000000000000000000000000000000000000000000000000000000001111111111111111111100000000000000000000000000000000000000000000000000000000000000000000000000000000000000000000
1111111111100000000000000000000000000000000000000000000000000000000000000000001111111111111111111100000000000000000000000000000000000000000000000000000000000000000000000000000000000000000000
1111111111111111111111111111111111111111111111111111111111111111111111111111111111111111111111111100000000000000000000000000000000000000000000000000000000000000000000000000000000000000000000
1111111111111111111111111111111111111111111111111111111111111111111111111111111111111111111111111100000000000000000000000000000000000000000000000000000000000000000000000000000000000000000000
1111111111111111111111111111111111111111111111111111111111111111111111111111111111111111111111111100000000000000000000000000000000000000000000000000000000000000000000000000000000000000000000
1111111111111111111111111111111111111111111111111111111111111111111111111111111111111111111111111100000000000000000000000000000000000000000000000000000000000000000000000000000000000000000000
1111111111111111111111111111111111111111111111111111111111111111111111111111111111111111111111111100000000000000000000000000000000000000000000000000000000000000000000000000000000000000000000
1111111111111111111111111111111111111111111111111111111111111111111111111111111111111111111111111100000000000000000000000000000000000000000000000000000000000000000000000000000000000000000000
1111111111111111111111111111111111111111111111111111111111111111111111111111111111111111111111111100000000000000000000000000000000000000000000000000000000000000000000000000000000000000000000
1111111111111111111111111111111111111111111111111111111111111111111111111111111111111111111111111100000000000000000000000000000000000000000000000000000000000000000000000000000000000000000000
1111111111111111111111111111111111111111111111111111111111111111111111111111111111111111111111111100000000000000000000000000000000000000000000000000000000000000000000000000000000000000000000
1111111111111111111111111111111111111111111111111111111111111111111111111111111111111111111111111100000000000000000000000000000000000000000000000000000000000000000000000000000000000000000000
1111111111111111111111111111111111111111111111111111111111111111111111111111111111111111111111111100000000000000000000000000000000000000000000000000000000000000000000000000000000000000000000
1111111111111111111111111111111111111111111111111111111111111111111111111111111111111111111111111100000000000000000000000000000000000000000000000000000000000000000000000000000000000000000000
1111111111111111111111111111111111111111111111111111111111111111111111111111111111111111111111111100000000000000000000000000000000000000000000000000000000000000000000000000000000000000000000
1111111111111111111111111111111111111111111111111111111111111111111111111111111111111111111111111100000000000000000000000000000000000000000000000000000000000000000000000000000000000000000000
1111111111111111111111111111111111111111111111111111111111111111111111111111111111111111111111111100000000000000000000000000000000000000000000000000000000000000000000000000000000000000000000
1111111111111111111111111111111111111111111111111111111111111111111111111111111111111111111111111100000000000000000000000000000000000000000000000000000000000000000000000000000000000000000000
1111111111111111111111111111111111111111111111111111111111111111111111111111111111111111111111111100000000000000000000000000000000000000000000000000000000000000000000000000000000000000000000
1111111111111111111111111111111111111111111111111111111111111111111111111111111111111111111111111100000000000000000000000000000000000000000000000000000000000000000000000000000000000000000000
1111111111111111111111111111111111111111111111111111111111111111111111111111111111111111111111111100000000000000000000000000000000000000000000000000000000000000000000000000000000000000000000
1111111111111111111111111111111111111111111111111111111111111111111111111111111111111111111111111100000000000000000000000000000000000000000000000000000000000000000000000000000000000000000000